0 0 0 0 0 0 0 0 0 0 0 0 0 0 0 0 0 0 0 0 0 0 0 0
0 0 0 r 0 0 0 0 0 0 0 0 r 0 0 0 0 0 0 0 0 0 0 0
0 0 0 A 0 - | 0 0 0 0 R R R 0 0 0 0 0 0 r 0 0 0
0 0 0 0 0 0 | 0 0 0 0 0 r 0 0 0 0 0 0 0 R 0 a 0
0 0 0 0 0 - 0 0 0 0 0 0 0 0 0 0 0 0 0 0 r 0 0 0
0 0 0 0 0 0 0 0 0 0 0 0 0 0 0 0 0 0 0 0 0 0 0 0
0 0 0 0 0 r 0 0 0 0 - - - | 0 0 0 0 0 0 0 0 0 0
0 0 0 0 0 r 0 0 0 | 0 0 0 | 0 0 0 0 0 / 0 0 0 0
0 0 0 0 0 R 0 0 T | 0 a 0 | 0 0 0 0 0 | 0 0 0 0
0 0 0 0 0 0 0 0 0 | 0 0 0 0 0 0 0 0 0 | 0 0 0 0
0 0 0 0 0 0 0 0 0 - - - - 0 0 0 0 0 0 - 0 0 0 0
0 0 0 0 R r 0 0 0 0 0 0 0 0 0 0 0 r 0 0 0 0 0 0
0 0 0 0 R R 0 0 0 0 0 0 0 0 0 0 R R 0 0 0 0 0 0
0 0 0 0 r 0 0 0 0 0 0 0 0 0 0 0 r 0 0 0 0 0 0 0
0 0 0 0 0 0 0 0 0 0 0 0 0 0 0 0 0 0 0 0 0 0 0 0