0 0 0 0 0 0 0 0 0 0 0 0 0 0 0 0 0 0 0 0 0 0 0 0
0 0 0 r 0 0 0 0 0 0 0 0 r 0 0 0 0 0 0 0 0 0 0 0
0 0 0 0 0 - | 0 0 0 0 R R R 0 0 0 0 0 0 r 0 0 0
0 0 A 0 0 0 | 0 0 0 0 0 r 0 0 0 0 0 0 0 R s 0 0
0 0 0 0 0 - 0 0 0 0 0 0 0 0 0 0 0 0 0 0 r 0 0 0
0 0 0 0 0 0 0 0 0 0 0 0 0 0 0 0 0 0 0 0 0 0 0 0
0 0 0 0 0 r 0 0 0 0 - - - | 0 0 0 0 0 0 0 0 0 0
0 0 0 0 0 r 0 0 0 | 0 0 T | 0 0 0 0 0 / 0 0 0 0
0 0 0 0 0 R 0 0 0 | 0 0 0 | 0 0 0 0 0 | 0 0 0 0
0 0 0 0 0 0 0 0 0 | a 0 0 0 0 0 0 0 0 | 0 0 0 0
0 0 0 0 0 0 0 0 0 - - - - 0 0 0 0 0 0 - 0 0 0 0
0 0 0 0 R r 0 0 0 0 0 0 0 0 0 0 0 r 0 0 0 0 0 0
0 S 0 0 R R 0 0 0 0 0 0 0 0 0 0 R R 0 0 0 0 0 0
0 0 0 0 r 0 0 0 0 0 0 0 0 0 0 0 r 0 0 0 0 0 0 0
0 0 0 0 0 0 0 0 0 0 0 0 0 0 0 0 0 0 0 0 0 0 0 0