0 0 0 0 0 0 0 0 0 0 0 0 0 0 0 0 0 0 0 0 0 0 0 0
0 0 a 0 0 0 0 0 0 0 0 0 0 0 0 0 0 0 s 0 0 0 0 0
0 | 0 0 | 0 0 0 0 0 0 0 0 0 0 0 0 0 0 0 0 0 0
0 - - - 0 0 0 0 0 0 0 0 0 0 0 0 r R R r 0 0 0 0
0 0 0 0 0 0 0 0 0 0 0 t 0 0 0 0 0 r r 0 0 0 0 0
0 0 0 0 0 0 0 0 0 0 0 0 0 0 0 0 0 0 0 0 0 0 0 0
0 0 0 0 0 0 0 0 0 0 r R 0 0 0 0 0 0 0 0 0 0 0 0
0 0 0 0 r 0 0 0 r R R R r 0 0 0 0 0 r R 0 0 0 0
0 0 0 r R 0 0 0 0 0 R r 0 0 0 0 0 0 0 0 0 0 0 0
0 0 0 0 0 0 0 0 0 0 0 0 0 0 0 0 0 0 - - - | 0 0
0 0 0 0 0 0 0 0 0 0 0 0 0 0 0 0 0 | 0 0 0 | 0 0
0 - - 0 0 0 0 0 0 0 0 0 0 0 0 0 0 | T 0 0 | 0 0
0 S 0 0 0 0 0 / - - - | 0 0 0 0 0 | 0 0 0 0 0 0
0 0 0 0 0 0 0 0 0 A 0 0 0 0 0 0 0 - - - - 0 0 0
0 0 0 0 0 0 0 0 0 0 0 0 0 0 0 0 0 0 0 0 0 0 0 0