0 0 0 0 r R R R R R R R R R R R R R r 0 0 0 0 0
0 0 0 0 r r R R R R R R R R R R R R r 0 0 0 0 0
0 0 0 0 0 r R R R R R R R R R R R R r 0 0 0 0 0
0 0 0 0 0 0 r R R R R R R R R R R r 0 0 r 0 0 0
0 0 0 0 0 0 r R R R R R R R R r r 0 0 0 r 0 a 0
0 0 0 0 0 0 0 r r r R R r r r r 0 0 0 0 r 0 0 0
0 0 0 0 0 0 0 0 0 0 r r r r r 0 0 0 0 0 0 0 0 0
0 0 0 S | 0 0 0 0 0 0 | | 0 0 0 0 0 r 0 0 0 0 0
0 - - - 0 0 0 0 0 0 0 0 0 0 0 0 0 r R 0 a 0 0 0
0 0 0 0 0 0 0 0 0 0 0 0 0 0 0 0 0 0 r 0 0 0 0 0
0 0 0 0 0 0 T r 0 0 0 | | 0 0 0 0 0 0 0 0 0 0 0
0 0 0 0 0 r R r 0 0 0 | | 0 t 0 0 0 0 0 0 s 0 0
0 A r 0 0 0 0 0 0 0 0 | | 0 0 0 0 0 0 | 0 0 0 0
0 r R r 0 0 0 0 0 0 0 0 0 0 0 0 0 0 0 - - - 0 0
0 r R r 0 0 0 0 r 0 0 0 0 0 0 0 0 0 0 0 0 0 0 0